35 20
~~~~~~~~~~~~~~~~###~~~~~~~~~~~~~~~~
~###~##~#~###~#~###~#~###~#~##~###~
~###~~~~~~###~#~###~#~###~~~~~~###~
~~~~~########~#~~~~~#~########~~~~~
~##~#########~#~###~#~#########~##~
~~~~~########~#~###~#~########~~~~~
~###~~~~#####~#~###~#~#####~~~~###~
~#~~~##~#####~~~~~~~~~#####~##~~~#~
~#~####~#####~##~#~##~#####~####~#~
~#~####~~~~~~~~~~#~~~~~~~~~~####~#~
~~~#########~###~#~###~#########~~~
#~##########~###~#~###~##########~#
#~##########~###~#~###~##########~#
#~##########~~~~~#~~~~~##########~#
#~#############~~~~~#############~#
~~~############~###~############~~~
~#~############~###~############~#~
~#~~~#~~~######~###~######~~~#~~~#~
~###~#~#~~~~~##~###~##~~~~~#~#~###~
~~~~~~~~~###~~~~~~~~~~~###~~~~~~~~~