35 20
~~~~~~####~~~#########~~~####~~~~~~
~##~#~####~#~#########~#~####~#~##~
~##~#~~~~~~~~#########~~~~~~~~#~##~
~##~#~#####~###########~#####~#~##~
~~~~~~#####~~~~~~~~~~~~~#####~~~~~~
~##########~#~#######~#~##########~
~##########~#~#######~#~##########~
~##########~~~~#####~~~~##########~
~#############~#####~#############~
~~~~~#########~#####~#########~~~~~
~###~~~~~~~~~~~~~~~~~~~~~~~~~~~###~
~###~####~####~#####~####~####~###~
~~~~~~~~~~####~~~~~~~####~~~~~~~~~~
~#~#~##########~###~##########~#~#~
~#~#~##########~~~~~##########~#~#~
~#~#~#########################~#~#~
~#~~~###########~~~###########~~~#~
~#~#~###########~#~###########~#~#~
~#~#~###########~#~###########~#~#~
~~~~~~~~~~~~~~~~~~~~~~~~~~~~~~~~~~~