35 20
~~~~~~~~~~~~~#########~~~~~~~~~~~~~
~#~##~##~###~#########~###~##~##~#~
~~~##~~~~###~~~~~~~~~~~###~~~~##~~~
~#~#####~#################~#####~#~
~~~~####~#################~####~~~~
~##~###~~~~~##~~~~~~~##~~~~~###~##~
~~~~###~###~##~#####~##~###~###~~~~
~##~~~~~~~~~##~#####~##~~~~~~~~~##~
~~~#####~##~~~~#####~~~~##~#####~~~
~#~~~###~##~##~#####~##~##~###~~~#~
~~~#~###~##~~~~~~~~~~~~~##~###~#~~~
~#~~~###~######~###~######~###~~~#~
~#~#~~~~~######~###~######~~~~~#~#~
~#~############~###~############~#~
~#~############~###~############~#~
~~~~~~~~~~~~~~~~###~~~~~~~~~~~~~~~~
~#~############~###~############~#~
~~~~###########~###~###########~~~~
~##~###########~~~~~###########~##~
~~~~###########################~~~~