35 20
~~~~~##~~~~~~~~#####~~~~~~~~##~~~~~
~#~#~~~~##~###~#####~###~##~~~~#~#~
~~~~~#####~###~#####~###~#####~~~~~
~##~######~#~~~~~~~~~~~#~######~##~
~##~######~#~##~###~##~#~######~##~
~~~~~~~~~~~~~##~###~##~~~~~~~~~~~~~
######~####~###~###~###~####~######
######~####~###~~~~~###~####~######
~~~~##~####~~~~~###~~~~~####~##~~~~
~##~##~####~#~#~###~#~#~####~##~##~
~##~~~~~~~~~~~~~~~~~~~~~~~~~~~~~##~
~~~~###~#######~###~#######~###~~~~
~###~~~~~######~###~######~~~~~###~
~###~###~######~###~######~###~###~
~###~###~######~###~######~###~###~
~###~~~~~######~###~######~~~~~###~
~####~#########~###~#########~####~
~~~~~~#########~###~#########~~~~~~
~##~#~#########~###~#########~#~##~
~~~~~~#########~~~~~#########~~~~~~