35 20
~~~~~##########~~~~~##########~~~~~
~#~#~##########~###~##########~#~#~
~~~#~~~~~~~~~~~~###~~~~~~~~~~~~#~~~
~###~#########################~###~
~###~#########################~###~
~~~~~~~~~~~~~~~~~~~~~~~~~~~~~~~~~~~
#~###~#####~#~##~#~##~#~#####~###~#
#~###~#####~#~##~#~##~#~#####~###~#
#~###~#####~#~##~#~##~#~#####~###~#
~~~~~~~~~~#~#~##~#~##~#~#~~~~~~~~~~
~##~#####~~~~~##~~~##~~~~~#####~##~
~##~#####~###############~#####~##~
~~~~#####~###############~#####~~~~
~##~#####~###############~#####~##~
~##~#####~~~~~~~~~~~~~~~~~#####~##~
~~~~~~~~~#################~~~~~~~~~
~##~#~##~#################~##~#~##~
~##~~~~~~#################~~~~~~##~
~##~#~##~#################~##~#~##~
~~~~~~~~~#################~~~~~~~~~