35 20
~~~~~~~#####~~~~~~~~~~~#####~~~~~~~
~#~#~#~#####~#~#####~#~#####~#~#~#~
~~~~~#~#####~#~~~~~~~#~#####~#~~~~~
###~##~#####~~~#####~~~#####~##~###
###~##~#####~#~#####~#~#####~##~###
###~##~#####~#~#####~#~#####~##~###
###~##~#####~#~#####~#~#####~##~###
###~##~#####~#~#####~#~#####~##~###
###~##~#####~#~#####~#~#####~##~###
##~~~~~~~~~~~#~#####~#~~~~~~~~~~~##
##~####~###~##~~~~~~~##~###~####~##
##~####~###~##~#####~##~###~####~##
##~####~~~~~##~#####~##~~~~~####~##
##~####~###~~~~#####~~~~###~####~##
~~~~###~###~##~#####~##~###~###~~~~
~##~~~~~~~~~~~~#####~~~~~~~~~~~~##~
~~~~####~##~##~#####~##~##~####~~~~
~##~##~~~~~~~~~~~~~~~~~~~~~~~##~##~
~##~##~#~######~###~######~#~##~##~
~~~~##~~~~~~~~~~###~~~~~~~~~~##~~~~