35 20
~~~~~~~~~~~~~#########~~~~~~~~~~~~~
~#####~###~#~#########~#~###~#####~
~~~##~~~~~~#~~~~###~~~~#~~~~~~##~~~
~#~##~###~##~##~###~##~##~###~##~#~
~~~##~#~~~~~~~~~~~~~~~~~~~~~#~##~~~
##~##~#~##~#~####~####~#~##~#~##~##
~~~##~~~##~~~####~####~~~##~~~##~~~
~#~#########~~~~~~~~~~~#########~#~
~~~###########~#~#~#~###########~~~
~#############~#~#~#~#############~
~#############~~~#~~~#############~
~#############~#####~#############~
~#############~#####~#############~
~~~###########~#####~###########~~~
~#~#########~~~#####~~~#########~#~
~#~####~~~##~#~~~~~~~#~##~~~####~#~
~#~####~#~##~#~#####~#~##~#~####~#~
~#~~~~~~#~#~~~~#####~~~~#~#~~~~~~#~
~#~###~##~#~#~#######~#~#~##~###~#~
~~~~~~~~~~~~~~~~~~~~~~~~~~~~~~~~~~~