35 20
~~~~~~~~~###~~~~~~~~~~~###~~~~~~~~~
~#######~~~~~~#######~~~~~~#######~
~#######~####~#######~####~#######~
~#######~~~~~~~~~~~~~~~~~~~#######~
~~~~~~~~###################~~~~~~~~
~##~###~###################~###~##~
~##~###~###################~###~##~
~##~###~###################~###~##~
~##~###~~~~#############~~~~###~##~
~~~~~~####~#############~####~~~~~~
#####~####~#############~####~#####
#####~####~#############~####~#####
###~~~####~#############~####~~~###
###~##~~~~~~~~~~~~~~~~~~~~~~~##~###
###~##~#####~###~#~###~#####~##~###
~~~~~~~#####~~~~~~~~~~~#####~~~~~~~
~#~###~#####~##~###~##~#####~###~#~
~~~~~~~~~~##~~~~###~~~~##~~~~~~~~~~
~##~#~###~##~##~###~##~##~###~#~##~
~~~~~~~~~~~~~~~~###~~~~~~~~~~~~~~~~