35 20
~~~####~~~###############~~~####~~~
~#~####~#~###############~#~####~#~
~~~~~~~~~~###############~~~~~~~~~~
#~##~##~#~###############~#~##~##~#
#~##~##~#~~~###########~~~#~##~##~#
#~~~~##~#~#~###########~#~#~##~~~~#
#~#####~#~#~###########~#~#~#####~#
#~###~~~~~#~####~~~####~#~~~~~###~#
#~###~#####~~~~~~#~~~~~~#####~###~#
~~~~~~##########~#~##########~~~~~~
~##~#~##########~#~##########~#~##~
~##~#~###~~~~~~#~#~#~~~~~~###~#~##~
~~~~~~###~####~~~~~~~####~###~~~~~~
~#~##~###~~~~~~#~#~#~~~~~~###~##~#~
~#~##~~~~~####~~~#~~~####~~~~~##~#~
~#~#######~~~~~#~~~#~~~~~#######~#~
~#~#######~#####~#~#####~#######~#~
~~~~~###~~~#####~#~#####~~~###~~~~~
~###~###~#~#####~#~#####~#~###~###~
~~~~~~~~~#~~~~~~~~~~~~~~~#~~~~~~~~~