35 20
~~~~~~~~~~~~~~~#####~~~~~~~~~~~~~~~
~########~####~#####~####~########~
~####~~~~~~~~~~~~~~~~~~~~~~~~~####~
~####~########~#####~########~####~
~####~########~#####~########~####~
~~~~~~########~~~~~~~########~~~~~~
~####~######~~~#~#~#~~~######~####~
~~~~~~######~#~~~#~~~#~######~~~~~~
~########~~~~~~#~#~#~~~~~~########~
~~~~#####~####~#~#~#~####~#####~~~~
~##~#####~####~~~#~~~####~#####~##~
~##~#####~###############~#####~##~
~~~~#####~###############~#####~~~~
~#~######~~~~~~~~~~~~~~~~~######~#~
~#~~~~~~~~#####~###~#####~~~~~~~~#~
~#~#~##~#######~~~~~#######~##~#~#~
~~~~~~~~###################~~~~~~~~
~##~#~#~###################~#~#~##~
~##~#~#~###################~#~#~##~
~~~~~~~~###################~~~~~~~~