35 20
~~~~~~~~~~~~~~~#####~~~~~~~~~~~~~~~
~####~####~###~~~~~~~###~####~####~
~#~~~~####~###~#####~###~####~~~~#~
~~~##~####~###~#####~###~####~##~~~
~#~##~~~~~~~~~~~~~~~~~~~~~~~~~##~#~
~#~####~###~##~#####~##~###~####~#~
~~~~~~~~~~#~##~#####~##~#~~~~~~~~~~
~#~#~##~#~#~##~#####~##~#~#~##~#~#~
~#~#~##~~~#~##~~~~~~~##~#~~~##~#~#~
~~~~~####~~~###########~~~####~~~~~
~##~#########~~~~~~~~~#########~##~
~##~#########~#######~#########~##~
~##~#########~#######~#########~##~
~~~~#########~#######~#########~~~~
~#~##########~#######~##########~#~
~#~##########~#######~##########~#~
~#~#~~~~~####~#######~####~~~~~#~#~
~#~#~###~####~#######~####~###~#~#~
~#~#~###~####~~~~~~~~~####~###~#~#~
~~~~~###~~~~~~#######~~~~~~###~~~~~