35 20
~~~~~~~~~~~~~~~~~~~~~~~~~~~~~~~~~~~
~#########~#############~#########~
~#########~#############~#########~
~#########~#############~#########~
~#########~#############~#########~
~#########~~~~~~~~~~~~~~~#########~
~###########~#########~###########~
~###########~#########~###########~
~~~~~~~~~~##~#########~##~~~~~~~~~~
~########~##~#########~##~########~
~########~#~~~~~~#~~~~~~#~########~
~########~~~####~#~####~~~########~
~########~#~~~~~~~~~~~~~#~########~
~######~~~#~####~#~####~#~~~######~
~######~###~####~#~####~###~######~
~~~~~~~~~~~~~~~#~#~#~~~~~~~~~~~~~~~
~####~####~###~~~#~~~###~####~####~
~~~~~~~~~~~###~#~~~#~###~~~~~~~~~~~
~###~##~#~####~~~#~~~####~#~##~###~
~~~~~~~~#~~~~~~#~~~#~~~~~~#~~~~~~~~