35 20
~~~~~~~~###################~~~~~~~~
~######~#####~~~~~~~~~#####~######~
~~~~###~#####~#######~#####~###~~~~
~##~###~#####~#######~#####~###~##~
~##~###~#####~#######~#####~###~##~
~~~~##~~~~~~~~#######~~~~~~~~##~~~~
~#~###~######~#######~######~###~#~
~#~#~~~~~~~~~~~~###~~~~~~~~~~~~#~#~
~#~#~########~#~###~#~########~#~#~
~~~~~####~~~~~#~###~#~~~~~####~~~~~
~###~####~###~~~~#~~~~###~####~###~
~###~####~####~#~#~#~####~####~###~
~###~####~~~~#~~~#~~~#~~~~####~###~
~##~~~######~###~~~###~######~~~##~
~##~#~~~~~##~###~#~###~##~~~~~#~##~
~##~~~###~##~###~#~###~##~###~~~##~
~##~#~###~##~###~~~###~##~###~#~##~
~~~~#~###~~~~###~#~###~~~~###~#~~~~
~####~###~######~#~######~###~####~
~~~~~~~~~~######~~~######~~~~~~~~~~