35 20
~~~~~~~~~~~~~~~~~~~~~~~~~~~~~~~~~~~
~##~#~####~#####~#~#####~####~#~##~
~##~#~~~##~#####~#~#####~##~~~#~##~
~##~#~#~##~#####~#~#####~##~#~#~##~
~##~#~#~##~#####~#~#####~##~#~#~##~
~##~#~~~~~~~~~~~~~~~~~~~~~~~~~#~##~
~##~#~##~###~###~#~###~###~##~#~##~
~~~~~~##~~~~~~~~~#~~~~~~~~~##~~~~~~
#####~####~##~#######~##~####~#####
#####~####~~~~#######~~~~####~#####
#####~#######~~~~~~~~~#######~#####
#####~#######~#######~#######~#####
~~~~~~#######~#######~#######~~~~~~
~####~#######~#######~#######~####~
~####~#######~#######~#######~####~
~~~~~~~~~~~~#~#######~#~~~~~~~~~~~~
~#~######~#~#~#######~#~#~######~#~
~#~~~~~~~~~~~~~~~~~~~~~~~~~~~~~~~#~
~#~#############################~#~
~~~#############################~~~