35 20
~~~~~~~~~~~~~~~~~~~~~~~~~~~~~~~~~~~
~##~#~#######################~#~##~
~~~~#~#######################~#~~~~
~#~#~~~~~~~~~~~#####~~~~~~~~~~~#~#~
~#~~~#########~#####~#########~~~#~
~###~#########~~~~~~~#########~###~
~###~#########~#####~#########~###~
~###~#########~#####~#########~###~
~~~~~#####~~~~~~~~~~~~~~~#####~~~~~
#~#~######~#~#########~#~######~#~#
#~#~######~#~#########~#~######~#~#
#~#~###~~~~#~#########~#~~~~###~#~#
#~#~###~##~#~#########~#~##~###~#~#
~~~~~~#~~~~#~#########~#~~~~#~~~~~~
~##~#~##~###~#########~###~##~#~##~
~##~#~##~###~#########~###~##~#~##~
~~~~~~##~###~#########~###~##~~~~~~
~##~####~###~#########~###~####~##~
~##~####~###~#########~###~####~##~
~~~~~~~~~###~~~~~~~~~~~###~~~~~~~~~