35 20
~~~~~~~~~~~~~~~~###~~~~~~~~~~~~~~~~
~##########~#~#~###~#~#~##########~
~##########~#~~~###~~~#~##########~
~##########~###~~~~~###~##########~
~~~~~~~~~~~~~##~###~##~~~~~~~~~~~~~
##~##~#~####~##~~~~~##~####~#~##~##
##~~~~#~####~#########~####~#~~~~##
##~##~#~####~#########~####~#~##~##
~~~##~#~####~#########~####~#~##~~~
~####~#~~~~~~~~~~~~~~~~~~~~~#~####~
~###~~~~###################~~~~###~
~###~##~~~~~~#########~~~~~~##~###~
~~~~~~#~####~#########~####~#~~~~~~
#~###~#~####~#########~####~#~###~#
#~###~#~####~#########~####~#~###~#
#~#~~~#~####~#########~####~#~~~#~#
~~~~#~~~~~~~~~#######~~~~~~~~~#~~~~
~##~####~##~#~#######~#~##~####~##~
~##~####~##~#~#######~#~##~####~##~
~~~~~~~~~~~~~~~~~~~~~~~~~~~~~~~~~~~