35 20
~~~~~###########~~~###########~~~~~
~#~#~########~~~~#~~~~########~#~#~
~#~~~######~~~#######~~~######~~~#~
~~~########~#~#######~#~########~~~
~#~~~~~####~#~~~~~~~~~#~####~~~~~#~
~#####~###~~~~#######~~~~###~#####~
~#####~###~#############~###~#####~
~~~~~#~###~#############~###~#~~~~~
~#~#~#~###~#############~###~#~#~#~
~~~~~~~~~~~~~~~~###~~~~~~~~~~~~~~~~
~#########~####~###~####~#########~
~#########~####~###~####~#########~
~######~~~~##~~~###~~~##~~~~######~
~######~#####~#~###~#~#####~######~
~~~~###~#####~~~###~~~#####~###~~~~
~##~###~#######~###~#######~###~##~
~##~###~#######~###~#######~###~##~
~~~~~~~~~~~~~~~~~~~~~~~~~~~~~~~~~~~
~##~#######~#~#~###~#~#~#######~##~
~~~~#######~~~#~~~~~#~~~#######~~~~