35 20
~~~~~###~~~~#~~~~~~~~~#~~~~###~~~~~
~###~###~##~#~#######~#~##~###~###~
~~~~~###~##~~~~~~~~~~~~~##~###~~~~~
#~##~#~~~##~##~#####~##~##~~~#~##~#
#~##~~~#~~~~##~#####~##~~~~#~~~##~#
#~##~#~####~##~~~~~~~##~####~#~##~#
#~~~~~~~~~~~~#########~~~~~~~~~~~~#
#####~######~#########~######~#####
#####~######~#########~######~#####
#####~####~~~#########~~~####~#####
~~~~~~####~#~#########~#~####~~~~~~
~#~##~##~~~~~#########~~~~~##~##~#~
~#~##~~~~#################~~~~##~#~
~#~##~##~#################~##~##~#~
~#~##~##~#################~##~##~#~
~~~~~~##~#################~##~~~~~~
~####~~~~#################~~~~####~
~~~~#~##~~~~~~#######~~~~~~##~#~~~~
~##~#~#####~#~~~~#~~~~#~#####~#~##~
~~~~~~#####~~~##~~~##~~~#####~~~~~~