35 20
~~~~~~~~~~#####~~~~~#####~~~~~~~~~~
~########~#####~#~#~#####~########~
~########~~~~~~~#~#~~~~~~~########~
~########~##~##~~~~~##~##~########~
~########~##~#########~##~########~
~########~~~~~#######~~~~~########~
~~~~~####~###~#######~###~####~~~~~
~###~####~###~#######~###~####~###~
~###~####~###~#######~###~####~###~
~###~####~###~#######~###~####~###~
~#~~~####~###~#######~###~####~~~#~
~#~#~####~~~~~#######~~~~~####~#~#~
~#~#~####~###~~~~~~~~~###~####~#~#~
~~~~~~~~~~###~#######~###~~~~~~~~~~
~##~#~#######~#######~#######~#~##~
~~~~#~#######~#######~#######~#~~~~
~####~######~~~~~~~~~~~######~####~
~####~~~~###~#~#~#~#~#~###~~~~####~
~####~##~###~#~#~#~#~#~###~##~####~
~~~~~~~~~~~~~#~~~~~~~#~~~~~~~~~~~~~