35 20
~~~~~~~~~~~~~~#######~~~~~~~~~~~~~~
~####~#~##~##~#######~##~##~#~####~
~####~~~##~##~~~###~~~##~##~~~####~
~######~~~~##~#~~~~~#~##~~~~######~
~#########~~~~#~###~#~~~~#########~
~##############~###~##############~
~##############~###~##############~
~##############~###~##############~
~##############~~~~~##############~
~##############~###~##############~
~~~~###########~###~###########~~~~
~##~~~~~~~~~###~###~###~~~~~~~~~##~
~##~####~##~~~#~###~#~~~##~####~##~
~##~####~##~#~#~~~~~#~#~##~####~##~
~~~~####~##~#~#######~#~##~####~~~~
~##~~~~#~~~~~~#######~~~~~~#~~~~##~
~#####~#~#~##~#######~##~#~#~#####~
~~~~~~~~~~~~~~~#####~~~~~~~~~~~~~~~
~##~##~###~###~#####~###~###~##~##~
~~~~~~~~~~~~~~~~~~~~~~~~~~~~~~~~~~~