35 20
~~~~~~~~~~~~~#########~~~~~~~~~~~~~
~######~##~#~~~~~~~~~~~#~##~######~
~####~~~##~~~#########~~~##~~~####~
~~~~~~####~#~#########~#~####~~~~~~
~####~####~#~#########~#~####~####~
~~~~~~####~#~#########~#~####~~~~~~
###~#~####~#~#########~#~####~#~###
###~~~~~~~~#~#########~#~~~~~~~~###
~~~~#~####~~~#########~~~####~#~~~~
~##~#~######~#########~######~#~##~
~##~#~######~#~~~~~~~#~######~#~##~
~##~~~######~#~#~#~#~#~######~~~##~
~####~####~~~~~#~~~#~~~~~####~####~
~####~####~#####~#~#####~####~####~
~~~~~~####~#####~#~#####~####~~~~~~
~##~######~#####~~~#####~######~##~
~##~######~~~~~~###~~~~~~######~##~
~##~~~~~~#~####~###~####~#~~~~~~##~
~##~####~#~####~###~####~#~####~##~
~~~~~~~~~~~~~~~~###~~~~~~~~~~~~~~~~