35 20
~~~~~~~~~~~~~~#######~~~~~~~~~~~~~~
~##~#~###~#~#~#######~#~#~###~#~##~
~##~#~~~~~#~#~#######~#~#~~~~~#~##~
~##~#~#####~#~~~~~~~~~#~#####~#~##~
~~~~~~###~~~~~#######~~~~~###~~~~~~
~########~####~~~~~~~####~########~
~########~####~#####~####~########~
~########~##~~~~###~~~~##~########~
~~~######~~~~##~###~##~~~~######~~~
##~#########~##~###~##~#########~##
##~#########~##~###~##~#########~##
##~#########~~~~~#~~~~~#########~##
##~#############~#~#############~##
##~#############~#~#############~##
~~~#############~#~#############~~~
~#~######~~~~~~~~~~~~~~~~~######~#~
~~~~~~~##~#~####~#~####~#~##~~~~~~~
~#~###~##~#~####~#~####~#~##~###~#~
~#~###~##~#~####~#~####~#~##~###~#~
~~~~~~~~~~~~~~~~~~~~~~~~~~~~~~~~~~~