35 20
~~~~~~####~~~~#######~~~~####~~~~~~
~####~~~~~~##~#######~##~~~~~~####~
~####~#######~#######~#######~####~
~####~#####~~~~~~~~~~~~~#####~####~
~~~~~~#####~###########~#####~~~~~~
~####~~~~~~~###########~~~~~~~####~
~~~##~#~#####~~~~~~~~~#####~#~##~~~
~#~##~~~#####~#######~#####~~~##~#~
~~~####~#####~#######~#####~####~~~
~#~####~#####~#######~#####~####~#~
~#~~~~~~~~~~~~~~###~~~~~~~~~~~~~~#~
~##~##~###~#~##~###~##~#~###~##~##~
~##~##~###~#~##~~~~~##~#~###~##~##~
~##~~~~###~#~#########~#~###~~~~##~
~##~##~~~~~#~#########~#~~~~~##~##~
~##~########~~~~~#~~~~~########~##~
~##~############~#~############~##~
~##~############~#~############~##~
~##~############~#~############~##~
~~~~############~~~############~~~~