35 20
~~~~~~~~~~~~~~~~~~~~~~~~~~~~~~~~~~~
~####~######~#~#~#~#~#~######~####~
~####~######~#~~~~~~~#~######~####~
~####~~~~~~~~~~#~#~#~~~~~~~~~~####~
~####~####~#~###~#~###~#~####~####~
~##~~~~~~~~#~###~#~###~#~~~~~~~~##~
~##~#~####~#~###~~~###~#~####~#~##~
~##~~~####~~~#########~~~####~~~##~
~~~~######~#############~######~~~~
#~#~######~#############~######~#~#
~~~~######~~~~#######~~~~######~~~~
~##~#######~#~#######~#~#######~##~
~~~~####~~~~~~~~~~~~~~~~~~~####~~~~
~##~####~###~#########~###~####~##~
~~~~####~###~#########~###~####~~~~
~#######~###~#########~###~#######~
~~~~####~###~#########~###~####~~~~
~##~###~~~~~~#########~~~~~~###~##~
~##~###~###################~###~##~
~~~~~~~~###################~~~~~~~~