35 20
~~~~~~~~~~~~~~~~~~~~~~~~~~~~~~~~~~~
~############~#######~############~
~############~#######~############~
~############~~~###~~~############~
~##############~###~##############~
~##############~###~##############~
~~~~~~~~~~~~~~~~~~~~~~~~~~~~~~~~~~~
~####~#########~###~#########~####~
~####~#########~~~~~#########~####~
~####~#######################~####~
~~~~~~~~~~~~~#########~~~~~~~~~~~~~
##~##~######~~~~###~~~~######~##~##
##~~~~######~##~###~##~######~~~~##
###~#~######~##~###~##~######~#~###
~~~~~~#~~~~~~~~~###~~~~~~~~~#~~~~~~
~######~#~#~###~###~###~#~#~######~
~######~#~~~~~~~###~~~~~~~#~######~
~~~~~~~~####~#########~####~~~~~~~~
~###~##~####~#########~####~##~###~
~~~~~~~~####~~~~~~~~~~~####~~~~~~~~