35 20
~~~############~~~~~############~~~
~#~############~#~#~############~#~
~#~~~~~~#######~#~#~#######~~~~~~#~
~#~####~~~~~~~~~~~~~~~~~~~~~####~#~
~~~####~##~##~#~###~#~##~##~####~~~
~#~####~~~~~~~~~###~~~~~~~~~####~#~
~#~~~~~##~#~#~#######~#~#~##~~~~~#~
~#~#~#~##~~~~~#######~~~~~##~#~#~#~
~~~~~~~##~##~~~~~~~~~~~##~##~~~~~~~
##~#~#~~~~##~##~###~##~##~~~~#~#~##
~~~#~####~~~~##~###~##~~~~####~#~~~
~#~~~~~~~~#####~###~#####~~~~~~~~#~
~~~#~##########~###~##########~#~~~
~#~#~##########~###~##########~#~#~
~~~#~##########~~~~~##########~#~~~
~#~~~##########~###~##########~~~#~
~#~############~~~~~############~#~
~~~~###########################~~~~
~##~###########################~##~
~~~~###########################~~~~