35 20
~~~~~~~~###################~~~~~~~~
~######~###################~######~
~######~###################~######~
~######~###################~######~
~~~~~##~#####~~~~~~~~~#####~##~~~~~
~###~##~#####~#######~#####~##~###~
~###~##~~~~~~~~~~#~~~~~~~~~~##~###~
~~~~~########~##~#~##~########~~~~~
~###~########~##~#~##~########~###~
~###~########~##~#~##~########~###~
~###~####~~~~~~~~~~~~~~~~~####~###~
~~~~~~~~#~#~####~#~####~#~#~~~~~~~~
#####~#~#~#~####~#~####~#~#~#~#####
#####~#~#~#~~~~~~#~~~~~~#~#~#~#####
#####~#~#~#####~###~#####~#~#~#####
~~~~~~~~#~#####~~~~~#####~#~~~~~~~~
~########~######~#~######~########~
~########~######~#~######~########~
~########~~~~~~#~#~#~~~~~~########~
~~~~~~~~~~####~~~~~~~####~~~~~~~~~~