35 20
~~~~~~########~~~~~~~########~~~~~~
~#~##~########~##~##~########~##~#~
~~~##~######~~~##~##~~~######~##~~~
~####~######~#~##~##~#~######~####~
~~~~~~~~~~~~~~~~~~~~~~~~~~~~~~~~~~~
~#######~########~########~#######~
~#######~########~########~#######~
~~~~~~~~~########~########~~~~~~~~~
~################~################~
~####~~~~~~~~~~~#~#~~~~~~~~~~~####~
~~~~~~#########~#~#~#########~~~~~~
~####~#########~~~~~#########~####~
~####~~~~~~~~#########~~~~~~~~####~
~~~~~~######~#########~######~~~~~~
~####~######~#########~######~####~
~~~~~~######~~~~~~~~~~~######~~~~~~
~#~#############################~#~
~#~~~~~~~~~~###########~~~~~~~~~~#~
~#####~####~###########~####~#####~
~~~~~~~~~~~~###########~~~~~~~~~~~~