35 20
~~~~~~~~~~~~~~~~~~~~~~~~~~~~~~~~~~~
~#~######~######~#~######~######~#~
~~~~~~###~######~#~######~###~~~~~~
~##~#~###~######~~~######~###~#~##~
~##~~~###~###############~###~~~##~
~##~#~###~###############~###~#~##~
~##~#~###~###############~###~#~##~
~~~~#~~~~~~#############~~~~~~#~~~~
##~#######~~~~~~###~~~~~~#######~##
##~#######~####~###~####~#######~##
##~#######~####~###~####~#######~##
##~#####~~~####~###~####~~~#####~##
##~#####~#~###~~~~~~~###~#~#####~##
##~~~~~#~#~###~#####~###~#~#~~~~~##
##~###~~~#~~~~~#####~~~~~#~~~###~##
##~###~#~#################~#~###~##
##~###~#~#################~#~###~##
~~~~~~~#~#################~#~~~~~~~
~#~#~#~#~~~~~~#######~~~~~~#~#~#~#~
~~~~~~~~~####~~~~~~~~~####~~~~~~~~~