35 20
~~~##~~~~~~#####~~~#####~~~~~~##~~~
~#~##~#~##~#####~#~#####~##~#~##~#~
~#~##~#~##~#####~#~#####~##~#~##~#~
~#~##~~~##~#####~#~#####~##~~~##~#~
~~~##~#~##~#####~#~#####~##~#~##~~~
~#~##~~~~~~~~~~~~~~~~~~~~~~~~~##~#~
~#~##~###~###############~###~##~#~
~~~~#~###~###############~###~#~~~~
~##~#~###~###############~###~#~##~
~~~~#~###~###############~###~#~~~~
~##~#~###~~~~~#######~~~~~###~#~##~
~##~#~#####~#~#######~#~#####~#~##~
~~~~~~~~~~~~~~~~~~~~~~~~~~~~~~~~~~~
~#~#~##~###################~##~#~#~
~#~#~~~~###################~~~~#~#~
~~~~~~#~###################~#~~~~~~
~####~#~###################~#~####~
~####~#~###################~#~####~
~####~#~###################~#~####~
~~~~~~~~~~~~~~~~~~~~~~~~~~~~~~~~~~~