35 20
~~~~~~~~~~~~~~~#####~~~~~~~~~~~~~~~
~##~#~#~##~###~#####~###~##~#~#~##~
~##~~~~~~~~~~~~~~~~~~~~~~~~~~~~~##~
~###~###~#################~###~###~
~###~###~#################~###~###~
~~~~~#~~~#################~~~#~~~~~
~#####~#~#################~#~#####~
~~~~~~~~~#################~~~~~~~~~
~#######~#######~~~#######~#######~
~#######~#######~#~#######~#######~
~#######~~~####~~~~~####~~~#######~
~#######~#~####~###~####~#~#######~
~#######~#~####~###~####~#~#######~
~#######~#~####~###~####~#~#######~
~#######~#~####~###~####~#~#######~
~~~~~~~~~#~~~~~~###~~~~~~#~~~~~~~~~
~#~#~#########################~#~#~
~#~#~#########################~#~#~
~#~#~~~~~#################~~~~~#~#~
~~~~~###~~~~~~~~~~~~~~~~~~~###~~~~~