35 20
~~~~~~~~~~~~~~~~~~~~~~~~~~~~~~~~~~~
~####~######~###~#~###~######~####~
~####~######~###~~~###~######~####~
~~~~~~~~~~~#~#########~#~~~~~~~~~~~
~####~####~#~~~#####~~~#~####~####~
~#~~~~~~##~#~#~#####~#~#~##~~~~~~#~
~#~####~##~#~#~~~~~~~#~#~##~####~#~
~#~~~~#~##~#~#########~#~##~#~~~~#~
~#~##~#~~~~~~~~#####~~~~~~~~#~##~#~
~#~##~########~#####~########~##~#~
~~~##~########~#####~########~##~~~
##~##~~~~#####~#####~#####~~~~##~##
##~#####~#####~#####~#####~#####~##
##~#####~#####~#####~#####~#####~##
~~~#~~~~~~~~##~#####~##~~~~~~~~#~~~
~###~#~####~~~~#####~~~~####~#~###~
~###~#~####~##~#####~##~####~#~###~
~###~~~####~##~#####~##~####~~~###~
~###~#~####~~~~~~#~~~~~~####~#~###~
~~~~~#~~~~~~####~~~####~~~~~~#~~~~~