35 20
~~~~~~########~~~~~~~########~~~~~~
~#~##~########~#####~########~##~#~
~~~~~~######~~~~~~~~~~~######~~~~~~
#~##~#######~#########~#######~##~#
#~##~~~~~###~#########~###~~~~~##~#
#~~~##~#~~~~~~~~~~~~~~~~~~~#~##~~~#
###~##~~~##~#~#~###~#~#~##~~~##~###
###~####~##~#~#~###~#~#~##~####~###
###~###~~~~~~~#~###~#~~~~~~~###~###
###~###~###~#~#~###~#~#~###~###~###
###~###~~~~~#~#~###~#~#~~~~~###~###
###~###~####~~~~###~~~~####~###~###
###~###~####~#########~####~###~###
###~###~####~#########~####~###~###
###~###~####~#########~####~###~###
~~~~~~#~####~#########~####~#~~~~~~
~####~~~~~~~~~~~###~~~~~~~~~~~####~
~####~#######~#~###~#~#######~####~
~####~#######~#~###~#~#######~####~
~~~~~~#######~~~~~~~~~#######~~~~~~