35 20
~~~~~#~~~~~~~~~~~~~~~~~~~~~~~#~~~~~
~#~#~#~######~#######~######~#~#~#~
~~~~~~~######~~~~~~~~~######~~~~~~~
~###~#########################~###~
~~~~~#########################~~~~~
~##~###########################~##~
~~~~###########################~~~~
~#~#############################~#~
~#~#############################~#~
~~~######~~~~~~#####~~~~~~######~~~
~#~######~####~#####~####~######~#~
~#~~~~~~~~####~#####~####~~~~~~~~#~
~#####~###~~~~~#####~~~~~###~#####~
~#####~###~###~#####~###~###~#####~
~~~~~~~~~#~###~~~~~~~###~#~~~~~~~~~
~####~##~~~#####~#~#####~~~##~####~
~####~##~#######~~~#######~##~####~
~~~~~~~~~~######~#~######~~~~~~~~~~
~######~#~######~#~######~#~######~
~~~~~~~~~~~~~~~~~~~~~~~~~~~~~~~~~~~