35 20
~~~~~~~~~~~~###########~~~~~~~~~~~~
~######~#~#~###########~#~#~######~
~######~#~#~###########~#~#~######~
~####~~~#~#~###########~#~#~~~####~
~~~~~~##~~~~~#########~~~~~##~~~~~~
~####~##~#~#~#########~#~#~##~####~
~~~~~~~~~#~#~~~~~~~~~~~#~#~~~~~~~~~
~####~####~#############~####~####~
~####~####~#############~####~####~
~####~####~~~#########~~~####~####~
~####~~~~~~#~###~~~###~#~~~~~~####~
~####~######~###~#~###~######~####~
~####~######~###~#~###~######~####~
~####~~~~~~~~~##~#~##~~~~~~~~~####~
~~~~~~##~####~##~#~##~####~##~~~~~~
~###~~~~~~~~~~##~~~##~~~~~~~~~~###~
~###~###~####~~~~#~~~~####~###~###~
~##~~~~~~#####~#####~#####~~~~~~##~
~##~##########~#####~##########~##~
~~~~##########~~~~~~~##########~~~~