35 20
~~~~~~~~~~~~~~##~~~##~~~~~~~~~~~~~~
~#####~#~##~#~##~#~##~#~##~#~#####~
~#####~#~~~~~~##~#~##~~~~~~#~#####~
~###~~~~~##~#~~~~~~~~~#~##~~~~~###~
~###~##~###~###~###~###~###~##~###~
~~~~~##~###~##~~~~~~~##~###~##~~~~~
~######~~~~~~~~#####~~~~~~~~######~
~###########~#~~~~~~~#~###########~
~~~#########~#~#####~#~#########~~~
~#~#########~#~#####~#~#########~#~
~#~#########~#~#####~#~#########~#~
~#~#########~#~#####~#~#########~#~
~~~~~~~~~~##~#~#####~#~##~~~~~~~~~~
~########~~~~~~#####~~~~~~########~
~########~####~#####~####~########~
~########~####~#####~####~########~
~~~~#~~~~~~###~#####~###~~~~~~#~~~~
~##~#~#~##~###~#####~###~##~#~#~##~
~##~#~#~##~###~#####~###~##~#~#~##~
~~~~~~~~~~~~~~~#####~~~~~~~~~~~~~~~