35 20
~~~~~~###~~~~~~~~#~~~~~~~~###~~~~~~
~##~#~###~####~#~#~#~####~###~#~##~
~##~#~###~~~~~~#~#~#~~~~~~###~#~##~
~##~#~##########~#~##########~#~##~
~~~~~~##########~#~##########~~~~~~
##~##~#####~~~~~~~~~~~~~#####~##~##
~~~##~#####~####~#~####~#####~##~~~
~#~~~~~~~~~~####~#~####~~~~~~~~~~#~
~#~##~###~######~#~######~###~##~#~
~~~~~~~~~~######~~~######~~~~~~~~~~
~#######~#######~#~#######~#######~
~#######~#######~~~#######~#######~
~#######~~~~~~~~~#~~~~~~~~~#######~
~###############~#~###############~
~###############~#~###############~
~###############~~~###############~
~~~~~###########~#~###########~~~~~
~###~###########~#~###########~###~
~###~###########~#~###########~###~
~~~~~~~~~~~~~~~~~#~~~~~~~~~~~~~~~~~