35 20
~~~~~~~~~~~~~~~~~~~~~~~~~~~~~~~~~~~
~##########~####~#~####~##########~
~##########~####~#~####~##########~
~##########~####~~~####~##########~
~##~~~~~###~#~~~~#~~~~#~###~~~~~##~
~##~###~###~#~#######~#~###~###~##~
~##~###~###~#~#######~#~###~###~##~
~##~#~~~~~~~#~#######~#~~~~~~~#~##~
~#~~~~#~#####~#######~#####~#~~~~#~
~#~##~#~~~~~~~#######~~~~~~~#~##~#~
~#~##~#~###################~#~##~#~
~#~##~#~########~~~########~#~##~#~
~~~~~~#~########~#~########~#~~~~~~
~##~#~#~########~#~########~#~#~##~
~##~~~#~########~#~########~#~~~##~
~##~###~########~#~########~###~##~
~~~~###~~~~#####~#~#####~~~~###~~~~
~##~####~#~#####~#~#####~#~####~##~
~##~####~#~#####~#~#####~#~####~##~
~~~~~~~~~#~~~~~~~~~~~~~~~#~~~~~~~~~