35 20
~~~~####~~~~~~~~~~~~~~~~~~~####~~~~
~##~####~#####~#~#~#~#####~####~##~
~##~####~###~~~~~~~~~~~###~####~##~
~##~~~~~~###~#~#~#~#~#~###~~~~~~##~
~######~####~#~#~#~#~#~####~######~
~######~####~~~~~#~~~~~####~######~
~######~####~#########~####~######~
~~~~~~~~####~~~~###~~~~####~~~~~~~~
#~##########~##~###~##~##########~#
#~##########~##~###~##~##########~#
#~~~########~##~###~##~########~~~#
#~#~######~~~~~~~~~~~~~~~######~#~#
~~#~######~#~#########~#~######~#~~
~##~######~#~#########~#~######~##~
~##~######~~~#########~~~######~##~
~##~######~#~#########~#~######~##~
~~~~~~~~~~~~~#########~~~~~~~~~~~~~
~###########~#########~###########~
~###########~#########~###########~
~~~~~~~~~~~~~~~~~~~~~~~~~~~~~~~~~~~