35 20
~~~~~~~~###################~~~~~~~~
~#~##~#~###################~#~##~#~
~~~##~#~###################~#~##~~~
~####~#~###################~#~####~
~~~~~~~~###################~~~~~~~~
~######~###################~######~
~####~~~###################~~~####~
~####~#~#~~~~~~~~~~~~~~~~~#~#~####~
~####~#~#~###~#######~###~#~#~####~
~~~~~~#~#~###~#######~###~#~#~~~~~~
~####~~~#~###~#######~###~#~~~####~
~######~~~~~~~~~~~~~~~~~~~~~######~
~#########~#~#########~#~#########~
~~~~~~~~~~~~~~~~~~~~~~~~~~~~~~~~~~~
~#########~#~#########~#~#########~
~#########~#~#########~#~#########~
~##~~~~~~~~#~#########~#~~~~~~~~##~
~##~######~#~#########~#~######~##~
~##~######~#~#########~#~######~##~
~~~~~~~~~~~#~~~~~~~~~~~#~~~~~~~~~~~