35 20
~~~~~~~~~~~~~~~~~~~~~~~~~~~~~~~~~~~
~#~##~#~###~#~##~#~##~#~###~#~##~#~
~#~#~~~~~~~~~~~~~~~~~~~~~~~~~~~#~#~
~#~~~###~###~#########~###~###~~~#~
~#~#~###~###~~~~~~~~~~~###~###~#~#~
~~~~~###~#################~###~~~~~
~###~###~#################~###~###~
~###~~~~~#################~~~~~###~
~~~~~##~###################~##~~~~~
####~##~###################~##~####
####~##~~~~~~~~~~~~~~~~~~~~~##~####
#~~~~##~###################~##~~~~#
#~##~~~~~#################~~~~~##~#
#~######~#################~######~#
#~~~~~~~~~###############~~~~~~~~~#
###~#~#~#~###############~#~#~#~###
~~~~~~~~~~###############~~~~~~~~~~
~###~#~##~~~~#########~~~~##~#~###~
~###~#~##~##~#########~##~##~#~###~
~~~~~~~~~~~~~#########~~~~~~~~~~~~~