35 20
~~~~~~~###~~~~~~###~~~~~~###~~~~~~~
~###~#~###~####~###~####~###~#~###~
~~~~~~~~~~~####~###~####~~~~~~~~~~~
~#####~###~####~###~####~###~#####~
~~~~~~~~~~~~~~~~###~~~~~~~~~~~~~~~~
~####~###~#####~~~~~#####~###~####~
~####~~~~~#####~###~#####~~~~~####~
~~#######~#####~~~~~#####~#######~~
#~#######~#####~###~#####~#######~#
#~#######~#####~###~#####~#######~#
#~#######~#####~~~~~#####~#######~#
~~~~#####~###############~#####~~~~
~##~#####~###############~#####~##~
~##~#####~###############~#####~##~
~##~#~~~#~###############~#~~~#~##~
~~~~~~#~#~###############~#~#~~~~~~
~#~##~~~~~######~~~######~~~~~##~#~
~#~##~###~######~#~######~###~##~#~
~#~~~~###~######~#~######~###~~~~#~
~~~######~~~~~~~~~~~~~~~~~######~~~