35 20
~~~~~~~~~~##~~~~~~~~~~~##~~~~~~~~~~
~########~##~###~#~###~##~########~
~########~~~~~~~~#~~~~~~~~########~
~###########~##~###~##~###########~
~#######~~~~~##~###~##~~~~~#######~
~#######~######~###~######~#######~
~~~#####~##~~~~~~~~~~~~~##~#####~~~
~#~#####~##~###########~##~#####~#~
~#~#####~##~###########~##~#####~#~
~~~~~~~~~~~~~~~~~~~~~~~~~~~~~~~~~~~
##~#####~###~##~###~##~###~#####~##
##~#####~###~##~###~##~###~#####~##
~~~###~~~###~~~~###~~~~###~~~###~~~
~#####~#~#################~#~#####~
~#####~#~#################~#~#####~
~#####~#~#######~~~#######~#~#####~
~####~~~~#######~#~#######~~~~####~
~####~##########~#~##########~####~
~####~~~~~~~~~~#~#~#~~~~~~~~~~####~
~~~~~~########~~~#~~~########~~~~~~