35 20
~~~~~~~~~~~~~~~~~~~~~~~~~~~~~~~~~~~
~#~###~###~##~##~#~##~##~###~###~#~
~#~###~###~##~~~~#~~~~##~###~###~#~
~#~###~###~##~##~#~##~##~###~###~#~
~~~~~~~~~~~~~~~~~~~~~~~~~~~~~~~~~~~
#~##~##########~###~##########~##~#
#~~~~##########~###~##########~~~~#
#~##~########~~~###~~~########~##~#
#~##~########~#######~########~##~#
~~##~####~~~~~~~~~~~~~~~~~####~##~~
~###~~~~~~###~#######~###~~~~~~###~
~########~~~~~#######~~~~~########~
~########~###############~########~
~########~###############~########~
~########~###############~########~
~########~###############~########~
~~~~~~~~~~###############~~~~~~~~~~
~#~#~####~##~~~~~~~~~~~##~####~#~#~
~#~#~~~~~~##~####~####~##~~~~~~#~#~
~~~~~####~~~~~~~~~~~~~~~~~####~~~~~