35 20
~~~#############################~~~
~#~#############################~#~
~~~#####~~~~###########~~~~#####~~~
~#~#####~##~###########~##~#####~#~
~#~~~~~~~~~~~~~~###~~~~~~~~~~~~~~#~
~#~#####~######~###~######~#####~#~
~#~~~~~~~######~###~######~~~~~~~#~
~~~##~#~#######~~~~~#######~#~##~~~
~#~~~~#~#######~###~#######~#~~~~#~
~~~##~#~#######~###~#######~#~##~~~
~####~#~####~~~~###~~~~####~#~####~
~##~~~~~~~~~~##~~~~~##~~~~~~~~~~##~
~##~#~#~####~#########~####~#~#~##~
~##~#~#~####~#########~####~#~#~##~
~~~~~~#~####~#########~####~#~~~~~~
~##~#~~~~~~~~~~~~~~~~~~~~~~~~~#~##~
~~~~~~~##~###############~##~~~~~~~
~#~#~#~##~###############~##~#~#~#~
~#~#~~~##~###############~##~~~#~#~
~~~~~#~~~~~~~~~~~~~~~~~~~~~~~#~~~~~