35 20
~~~~~~~~~~###############~~~~~~~~~~
~####~#~#~###############~#~#~####~
~####~#~#~###############~#~#~####~
~####~#~#~###############~#~#~####~
~~~~~~#~#~###############~#~#~~~~~~
~####~~~~~~~~~~#####~~~~~~~~~~####~
~#######~#####~~~~~~~#####~#######~
~#######~~~~~~~#####~~~~~~~#######~
~#######~#~#~#~#####~#~#~#~#######~
~~~~~~~~~#~#~#~#####~#~#~#~~~~~~~~~
~#########~#~#~#####~#~#~#########~
~~~~~~##~~~#~#~#####~#~#~~~##~~~~~~
~####~##~#~~~~~#####~~~~~#~##~####~
~####~##~#~###~~~~~~~###~#~##~####~
~~~~#~##~~~###~##~##~###~~~##~#~~~~
~##~~~##~#~###~##~##~###~#~##~~~##~
~~~~#~~~~~~~~~~~~~~~~~~~~~~~~~#~~~~
~##~~~########~##~##~########~~~##~
~####~########~~~~~~~########~####~
~~~~~~#######################~~~~~~