35 20
~~~~~~~~~~~~~~~~~~~~~~~~~~~~~~~~~~~
~##~#~#######################~#~##~
~##~#~#######################~#~##~
~~~~~~#######################~~~~~~
~##~#~~~~~~~~~~~###~~~~~~~~~~~#~##~
~##~###########~###~###########~##~
~~~~###########~~~~~###########~~~~
~#~~~~~~#######~###~#######~~~~~~#~
~#~####~#######~###~#######~####~#~
~#~####~#######~###~#######~####~#~
~#~####~~~~~~~~~###~~~~~~~~~####~#~
~#~####~######~#####~######~####~#~
~#~~~~~~######~#####~######~~~~~~#~
~#~###########~#####~###########~#~
~#~#####~~~~##~#####~##~~~~#####~#~
~#~#####~##~##~#####~##~##~#####~#~
~~~#####~##~~~~#####~~~~##~#####~~~
~#~#####~#####~~~~~~~#####~#####~#~
~#~#####~#################~#####~#~
~~~~~~~~~~~~~~~~~~~~~~~~~~~~~~~~~~~