35 20
~~~~~~#######################~~~~~~
~##~#~#######################~#~##~
~##~#~#######################~#~##~
~##~#~######~~~~~~~~~~~######~#~##~
~##~#~######~#########~######~#~##~
~##~#~######~#########~######~#~##~
~##~#~##~~~#~#########~#~~~##~#~##~
~~~~~~##~#~#~#########~#~#~##~~~~~~
###~#~##~#~~~~~~###~~~~~~#~##~#~###
###~#~~~~#~##~#~~~~~#~##~#~~~~#~###
~~~~~~#~~~~##~#~###~#~##~~~~#~~~~~~
~##~#~#~##~##~#~###~#~##~##~#~#~##~
~##~#~#~##~##~#~###~#~##~##~#~#~##~
~~~~~~~~~~~~~~#~###~#~~~~~~~~~~~~~~
~#~#~##########~###~##########~#~#~
~~~#~#####~~~~~~~~~~~~~~~#####~#~~~
~#~#~#####~###~#####~###~#####~#~#~
~~~~~#####~###~#####~###~#####~~~~~
~#~#~#####~###~#####~###~#####~#~#~
~~~~~~~~~~~###~~~~~~~###~~~~~~~~~~~