35 20
~~~~~~~~~~~~~~~~~~~~~~~~~~~~~~~~~~~
~##~#~#~##~##~#~###~#~##~##~#~#~##~
~##~#~#~##~##~#~###~#~##~##~#~#~##~
~~~~~~~~##~##~#~###~#~##~##~~~~~~~~
~#######~~~##~#~###~#~##~~~#######~
~#######~####~#~###~#~####~#######~
~#######~####~#~~~~~#~####~#######~
~#######~####~#~###~#~####~#######~
~#######~~~~~~#~###~#~~~~~~#######~
~##~~~~~~######~~~~~######~~~~~~##~
~##~####~#################~####~##~
~~~~####~~~~~#########~~~~~####~~~~
~###########~#########~###########~
~###########~#########~###########~
~~~#########~#########~#########~~~
~#~~~~######~#########~######~~~~#~
~#~##~######~#########~######~##~#~
~~~##~######~#########~######~##~~~
~#~##~~~~~~~~~~~~~~~~~~~~~~~~~##~#~
~~~~~~#######################~~~~~~