35 20
~~~~~~~~~~~###~~~~~~~###~~~~~~~~~~~
~##~######~~~~~#####~~~~~######~##~
~~~~######~###~#####~###~######~~~~
~##~######~###~#####~###~######~##~
~~~~~~~~~~~###~#####~###~~~~~~~~~~~
~#~###~#######~~~~~~~#######~###~#~
~#~~~#~#####################~#~~~#~
~#~#~~~#####################~~~#~#~
~#~~~#########################~~~#~
~~~#~######~~~~#~~~#~~~~######~#~~~
~#~#~######~##~#~#~#~##~######~#~#~
~#~#~######~##~#~#~#~##~######~#~#~
~~~#~##~~~~~~#~#~#~#~#~~~~~~##~#~~~
~#~#~##~####~#~~~#~~~#~####~##~#~#~
~#~~~~~~####~###~~~###~####~~~~~~#~
~~~~########~###~#~###~########~~~~
~##~########~~~~~#~~~~~########~##~
~##~###########################~##~
~##~###########################~##~
~~~~###########################~~~~