35 20
~~~#####~~~~~~#######~~~~~~#####~~~
~#~#####~####~#######~####~#####~#~
~~~~~###~####~#######~####~###~~~~~
~#~#~###~~~~#~#######~#~~~~###~#~#~
~~~~~~~~###~#~#######~#~###~~~~~~~~
~######~###~~~#######~~~###~######~
~######~###~#~#######~#~###~######~
~~~####~~~~~#~~~~~~~~~#~~~~~####~~~
~#~~~~~~#####~#######~#####~~~~~~#~
~~~##########~#~~~~~#~##########~~~
##~##########~#~###~#~##########~##
##~##########~#~###~#~##########~##
##~#######~~~~#~###~#~~~~#######~##
##~#######~####~###~####~#######~##
~~~#~~~~~~~####~###~####~~~~~~~#~~~
~###~####~~~~~#~###~#~~~~~####~###~
~###~####~###~#~###~#~###~####~###~
~###~~~~~~###~~~~~~~~~###~~~~~~###~
~###~####~####~#####~####~####~###~
~~~~~~~~~~~~~~~~~~~~~~~~~~~~~~~~~~~