35 20
~~~~~~~~~~~~~~~#####~~~~~~~~~~~~~~~
~##~##########~~~~~~~##########~##~
~#~~~~~~~~~~~~~#####~~~~~~~~~~~~~#~
~#~##~####~#############~####~##~#~
~~~~~~####~~~~~#####~~~~~####~~~~~~
####~#####~###~#####~###~#####~####
####~#####~###~~~~~~~###~#####~####
####~#####~~~~~#####~~~~~#####~####
####~#########~#####~#########~####
####~#########~#####~#########~####
####~#########~#####~#########~####
####~#########~#####~#########~####
####~#########~#####~#########~####
####~##~~~~~~~~~~~~~~~~~~~~~##~####
####~##~######~#####~######~##~####
~~~~~~~~~~~~~#~#####~#~~~~~~~~~~~~~
~####~#~##~#~#~#####~#~#~##~#~####~
~###~~~~##~#~#~~~#~~~#~#~##~~~~###~
~###~#~###~#~###~#~###~#~###~#~###~
~~~~~~~###~~~~~~~~~~~~~~~###~~~~~~~