35 20
~~~~~~~~####~~~#####~~~####~~~~~~~~
~###~##~####~#~~~~~~~#~####~##~###~
~~~~~##~##~~~#~#####~#~~~##~##~~~~~
~#~####~~~~#~~~#####~~~#~~~~####~#~
~#~####~##~#~#########~#~##~####~#~
~#~####~~~~~~#########~~~~~~####~#~
~~~~~~~~###~###########~###~~~~~~~~
~#~##~#~###~###########~###~#~##~#~
~~~##~#~###~###########~###~#~##~~~
~#~##~~~~~~~~~~~~~~~~~~~~~~~~~##~#~
~#~#############~#~#############~#~
~#~#############~#~#############~#~
~~~~############~#~############~~~~
~##~############~#~############~##~
~##~#~~~~~~~~~~~~~~~~~~~~~~~~~#~##~
~##~#~##########~#~##########~#~##~
~##~#~##########~#~##########~#~##~
~##~#~##########~~~##########~#~##~
~##~#~#######################~#~##~
~~~~~~#######################~~~~~~