35 20
~~~~~~~~~#################~~~~~~~~~
~####~##~#################~##~####~
~~~~~~##~#################~##~~~~~~
~####~~~~#################~~~~####~
~~~##~##~####~~~~~~~~~####~##~##~~~
##~##~##~####~#######~####~##~##~##
##~##~##~####~~~~#~~~~####~##~##~##
##~##~~~~####~##~#~##~####~~~~##~##
~~~~~~##~~~~~~~~~~~~~~~~~~~##~~~~~~
~##~#~~~~###~#########~###~~~~#~##~
~##~##~#~###~#########~###~#~##~##~
~##~##~#~###~#########~###~#~##~##~
~##~##~#~~~~~#########~~~~~#~##~##~
~##~~~~~~###~~~~~~~~~~~###~~~~~~##~
~##~##########~#####~##########~##~
~##~##########~#####~##########~##~
~~~~~~########~#####~########~~~~~~
~##~#~########~#####~########~#~##~
~##~#~########~#####~########~#~##~
~~~~~~########~~~~~~~########~~~~~~